-1 -1 -1 -1 -1 -1 -1 -1 -1 -1 -1 -1 -1 -1 -1 -1 -1 -1 -1 -1 -1 -1 -1 -1 -1 -1 -1 -1 -1 -1 -1 -1 -1 -1 -1 -1 -1 -1 -1 -1 -1 -1 -1 -1 -1 -1
-1 -1 -1 -1 -1 -1 -1 -1 -1 -1 -1 -1 -1 -1 -1 -1 -1 -1 -1 -1 -1 -1 -1 -1 -1 -1 -1 -1 -1 -1 -1 -1 -1 -1 -1 -1 -1 -1 -1 -1 -1 -1 -1 -1 -1 -1
-1 -1 -1 -1 -1 -1 -1 -1 -1 -1 -1 -1 -1 -1 -1 -1 -1 -1 -1 -1 -1 -1 -1 -1 -1 -1 -1 -1 -1 -1 -1 -1 -1 -1 -1 -1 -1 -1 -1 -1 -1 -1 -1 -1 -1 -1
-1 -1 -1 -1 -1 -1 -1 -1 -1 -1 -1 -1 -1 -1 -1 -1 -1 -1 -1 -1 -1 -1 -1 -1 -1 -1 -1 -1 -1 -1 -1 -1 -1 -1 -1 -1 -1 -1 -1 -1 -1 -1 -1 -1 -1 -1
-1 -1 -1 -1 -1 -1 -1 -1 -1 -1 -1 -1 -1 -1 -1 -1 -1 -1 -1 -1 -1 -1 -1 -1 -1 -1 -1 -1 -1 -1 -1 -1 -1 -1 -1 -1 -1 -1 -1 -1 -1 -1 -1 -1 -1 -1
-1 -1 -1 -1 -1 -1 -1 -1 -1 -1 -1 -1 -1 -1 -1 -1 -1 -1 -1 -1 -1 -1 -1 -1 -1 -1 -1 -1 -1 -1 -1 -1 -1 -1 -1 -1 -1 -1 -1 -1 -1 -1 -1 -1 -1 -1
-1 -1 -1 -1 -1 -1 -1 -1 -1 -1 -1 -1 -1 -1 -1 -1 -1 -1 -1 -1 -1 -1 -1 -1 -1 -1 -1 -1 -1 -1 -1 -1 -1 -1 -1 -1 -1 -1 -1 -1 -1 -1 -1 -1 -1 -1
-1 -1 -1 -1 -1 -1 -1 -1 -1 -1 -1 -1 -1 -1 -1 -1 -1 -1 -1 -1 -1 -1 -1 -1 -1 -1 -1 -1 -1 -1 -1 -1 -1 -1 -1 -1 -1 -1 -1 -1 -1 -1 -1 -1 -1 -1
-1 -1 08 -1 -1 -1 -1 -1 -1 -1 -1 -1 -1 08 -1 -1 -1 -1 -1 -1 -1 -1 -1 -1 -1 08 -1 -1 -1 -1 -1 -1 -1 -1 -1 -1 08 -1 -1 -1 -1 -1 -1 -1 -1 -1
-1 08 08 08 -1 -1 -1 -1 -1 09 -1 -1 08 08 -1 -1 -1 -1 -1 09 -1 -1 -1 -1 08 08 08 -1 -1 -1 -1 -1 09 -1 -1 08 08 -1 -1 -1 -1 -1 09 -1 -1 -1
03 00 01 01 01 02 05 06 06 03 00 02 04 05 06 06 06 06 03 04 05 06 06 03 00 01 01 01 02 05 06 06 03 00 02 04 05 06 06 06 06 03 04 05 06 06
10 11 11 07 11 07 12 13 13 10 07 11 11 12 13 13 13 13 10 07 12 13 13 10 11 11 07 11 07 12 13 13 10 07 11 11 12 13 13 13 13 10 07 12 13 13
10 07 11 11 11 11 12 13 13 10 11 07 07 12 13 13 13 13 10 11 12 13 13 10 07 11 11 11 11 12 13 13 10 11 07 07 12 13 13 13 13 10 11 12 13 13
10 11 11 11 07 11 12 13 13 10 11 11 11 12 13 13 13 13 10 11 12 13 13 10 11 11 11 07 11 12 13 13 10 11 11 11 12 13 13 13 13 10 11 12 13 13
10 11 07 11 11 11 12 13 13 10 07 11 11 12 13 13 13 13 10 11 12 13 13 10 11 07 11 11 11 12 13 13 10 07 11 11 12 13 13 13 13 10 11 12 13 13